000000000000000000000000
000000000000040000000000
000000000400000000040000
000000111111111111000000
000000100500005001000000
000004103002200301000000
000000100030030001400000
000400150000000051000000
000000111111111111000000
000000000000400000000000
000000004000000000000000
000000000000000000000000